{
    "levels": [
        {
            "map": [
                "__________________________________________________",
                "____@_____________________________________________",
                "__________________________________________________",
                "__________________________________________________",
                "__________________________________________________",
                "__________________________________________________",
                "__________________________________________________",
                "____________________________________________%_____",
                "__^_______________^^_____^^^________________#_____",
                "##################################################"
            ]
        },
        {
            "map": [
                "__________________________________________________",
                "____@_____________________________________________",
                "__________________________________________________",
                "__________________________________________________",
                "__________________________________________________",
                "__________________________________________________",
                "___________________#______________________________",
                "___________________#________________________%_____",
                "__________________##^__#xxxx#_______________#_____",
                "##################################################"
            ]
        },
        {
            "item": 0,
            "map": [
                "__________________________________________________",
                "____@_____________________________________________",
                "__________________________________________________",
                "__________________________________________________",
                "__________________________________________________",
                "__________________________________________________",
                "__________________________________________________",
                "__________________________*_________________%_____",
                "__________________##_____###________________#_____",
                "##################################################"
            ]
        }
    ]
}
