{
    "levels": [
        {
            "map": [
                "________________________o_________________________",
                "_____________________o____________________________",
                "____________________o__'__________________________",
                "_______________________'___o_________###__________",
                "####___________________'o____#_______#x#__________",
                "_o_#______''''''''_____'___o_#________x___________",
                "_@_#______''''''''_____'_____#________x_____%p____",
                "~~~~~~~~~#''''''''_____'_____#________x_____pp____",
                "~~~~~~~~~#ffffffff^^^^^'^^^^^#^^^_____xx____##___^",
                "#######################r#############xxx##########"
            ]
        },
        {
            "map": [
                "__________________________________________________",
                "____@_____________________________________________",
                "__________________________________________________",
                "__________________________________________________",
                "__________________________________________________",
                "__________________________________________________",
                "___________________#________________________%p____",
                "___________________#________________________pp____",
                "__________________##^__#xxxx#_______________##____",
                "##################################################"
            ]
        },
        {
            "item": 0,
            "map": [
                "__________________________________________________",
                "____@_____________________________________________",
                "__________________________________________________",
                "__________________________________________________",
                "__________________________________________________",
                "__________________________________________________",
                "__________________________________________________",
                "__________________________*_________________%p____",
                "__________________##_____###________________pp____",
                "##################################################"
            ]
        }
    ]
}
