{
    "levels": [
        {
            "map": [
                "_______________________'__________________________",
                "_______________________'__________________________",
                "_______________________'_________o________________",
                "_______________________'___o_________###__________",
                "####___________________'o____#_______#x#__________",
                "_o_#______''''''''_____'___o_#________x___________",
                "_@_#______''''''''o____'_____#________x_____%p____",
                "~~~~~~~~~#''''''''___o_'_____#________x_____pp____",
                "~~~~~~~~~#ffffffff^^^^^'^^^^^#^^^_____xx____##___^",
                "~~~~~~~~~##############r#############xxx##########"
            ]
        },
        {
            "map": [
                "__________________________________________________",
                "____@_____________________________________________",
                "__________________________________________________",
                "__________________________________________________",
                "__________________________________________________",
                "__________________________________________________",
                "___________________#________________________%p____",
                "___________________#________________________pp____",
                "__________________##^__#xxxx#_______________##____",
                "##################################################"
            ]
        },
        {
            "item": 2,
            "map": [
                "__________________________________________________",
                "____@_____________________________________________",
                "__________________________________________________",
                "__________________________________________________",
                "__________________________________________________",
                "__________________________________________________",
                "__________________________*_______________________",
                "____________________________________________%p____",
                "__________________##_____###________________pp____",
                "##################################################"
            ]
        }
    ]
}
