{
    "levels": [
        {
            "map": [
                "__________________________________________________",
                "__________________________________________________",
                "_o__@_____________________________________________",
                "____#_____________________________________________",
                "__________________________________________________",
                "_________________'________________________________",
                "_________________'__________________________%p____",
                "______#~~#_______'__________________________pp____",
                "__^___#~~#___ff__r^^_____^^^________________##___^",
                "##################################################"
            ]
        },
        {
            "map": [
                "__________________________________________________",
                "____@_____________________________________________",
                "__________________________________________________",
                "__________________________________________________",
                "__________________________________________________",
                "__________________________________________________",
                "___________________#________________________%p____",
                "___________________#________________________pp____",
                "__________________##^__#xxxx#_______________##____",
                "##################################################"
            ]
        },
        {
            "item": 0,
            "map": [
                "__________________________________________________",
                "____@_____________________________________________",
                "__________________________________________________",
                "__________________________________________________",
                "__________________________________________________",
                "__________________________________________________",
                "__________________________________________________",
                "__________________________*_________________%p____",
                "__________________##_____###________________pp____",
                "##################################################"
            ]
        }
    ]
}
