{
    "levels": [
        {
            "map": [
                "__________________________________________________",
                "____@_____________________________________________",
                "__________________________________________________",
                "__________________________________________________",
                "__________________________________________________",
                "__________________________________________________",
                "__________________________________________________",
                "____________________________________________%_____",
                "__________________^^_____^^^________________#_____",
                "##################################################"
            ]
        },
    ]
}
